- i i i -,
- - - - -,
- - i - -,
- - - - -,
- - - - -,
- - - - -,
- - - - -,
- - - - -,
- - - - -,
- - - - -,
- - - - -,
- - - - -,
- - - - -,
- - - - -,
- - - - -,
- - - - -,
Layer2 #
- - - - -,
- - - - -,
- - - - -,
- - - - -,
- - i - -,
- - - - -,
- i - - -,
- - - - -,
- - - - -,
- - - - -,
- - - - -,
- - - - -,
- - - - -,
- - - - -,
- - - - -,
- - - - -,
Layer 3#
- - - - -,
- - - - -,
- - - - -,
- - - - -,
- - - - -,
- - - - -,
- - - - -,
- i - - -,
- - - - -,
- - - i -,
- - i i -,
- - - - -,
- i - - -,
- - - - -,
- - i - -,
- - - - -,
Layer 4 #
- - - - -,
- - - - -,
- - - - -,
- - - - -,
- - - - -,
- - - - -,
- - - - -,
- - - - -,
- - - - -,
- - - - -,
- - - - -,
- - - - -,
- - - - -,
- - - - -,
- - - - -,
- x x x -,
Left Wall#
> > > > ,
> - > - ,
> > > > ,
> - > > ,
> > > > ,
> > - > ,
> > > > ,
> > > > ,
> > > > ,
> > > > ,
> > > > ,
> > > > ,
> > > > ,
> > > > ,
> > > > ,
> > > > ,
Right Wall#
> > > > ,
> > > > ,
> > > > ,
> > > > ,
> > > > ,
> > > > ,
> > > > ,
> > > > ,
> > > > ,
> > > > ,
> > > > ,
> > > > ,
> > > > ,
> > > > ,
> > > > ,
> > > > ,