- x x x -,
- - - - -,
s - s - s,
- - - - -,
- - - - -,
- - - - -,
- - - - -,
- - - - -,
- - - - -,
- - - - -,
- - - - -,
- - - - -,
- - - - -,
- - - - -,
- - - - -,
- - - - -,
Layer2 #
- - - - -,
- - - - -,
- - - - -,
- s - s -,
- - - - -,
s - s - s,
- - - - -,
- - - - -,
- - C - -,
- - - - -,
- - - - -,
- - - - -,
- - - - -,
C - - - -,
- - - - -,
- - - - -,
Layer 3#
- - - - -,
- - - - -,
- - - - -,
- - - - -,
- - - - -,
- - - - -,
- - - - -,
- s - s -,
- - - - -,
s - s - -,
- - - - -,
- - - - -,
- - - - -,
- - s - -,
- - - - -,
- - - - -,
Layer 4 #
- - - - -,
- - - c -,
- - - - -,
- - - - -,
- - - - -,
- - - - -,
- c - - -,
- - - - -,
- - - - -,
- - - - -,
- - - - -,
- - - - -,
- - - c -,
- - - - -,
- - - - -,
- x x x -,
Left Wall#
> > > > ,
> > > > ,
> > > > ,
> > > > ,
> > > > ,
> > > > ,
> > > > ,
> > > > ,
> > > > ,
> > > > ,
> > > > ,
> > > > ,
> > > > ,
> > > > ,
> > > > ,
> > > > ,
Right Wall#
> > > > ,
> > > > ,
> > > > ,
> > > > ,
> > > > ,
> > > > ,
> > > > ,
> > > > ,
> > > > ,
> > > > ,
> > > > ,
> > > > ,
> > > > ,
> > > > ,
> > > > ,
> > > > ,