x x x x x,
- - - - -,
- - - - -,
- - - - -,
- - - - -,
- - - - -,
- - - - -,
- - - - -,
- - - - -,
- - - - -,
- - - - -,
- - - - -,
- - - - -,
- - - - -,
- - - - -,
- - - - -,
Layer2 #
- - - - -,
- - - - -,
- x - x -,
- - - - -,
- - - C -,
x - - - -,
- - - - -,
- - - - -,
- - - - -,
- - - - -,
- - - - -,
- - - - -,
- - - - -,
- - - - -,
- - - - -,
- - - - -,
Layer 3#
- - - - -,
- - - - -,
- - - - -,
- - - - -,
- - - - -,
- - - - -,
- - - - -,
- - - - -,
- x - c -,
- - - x -,
- x - - -,
- x x - -,
- - - - -,
- - - - -,
- - - x -,
- - - - -,
Layer 4 #
- - - - -,
- - - - -,
- - - - -,
- - - - -,
- - - - -,
- - - - -,
- - - - -,
- - - - -,
- - - - -,
- - - - -,
- - - - -,
- - - - -,
- - - - -,
- - - - -,
- - - - -,
- x x x -,
Left Wall#
> > > > ,
> > > > ,
> > > > ,
> > > > ,
> > > > ,
> > > > ,
> > > > ,
> > > > ,
> > > > ,
> > > > ,
> > > > ,
> > > > ,
> > > > ,
> > > > ,
> > > > ,
> > > > ,
Right Wall#
> > > > ,
> > > > ,
> > > > ,
> > > > ,
> > > > ,
> > > > ,
> > > > ,
> > > > ,
> > > > ,
> > > > ,
> > > > ,
> > > > ,
> > > > ,
> > > > ,
> > > > ,
> > > > ,