x x x x x
- - - - -
- x - x -
c - - - -
- - - x -
x - - - - 
- - - c - 
- - - - - 
- x - - -
- - - x -
- x - - -
- x x - -
- - c - -
c - - - -
- - - x -
x x x x x